NO ./textures/kita.xpm
SO ./textures/minami.xpm
WE ./textures/nishi.xpm
EA ./textures/higashi.xpm

F 85,107,47
C 30,144,255

11111111111111111
10000000000000001
11100000000000001
   10000000000001
111000N0000000001
10000000000000001
10000000000000001
10000000000000001
11111111111111111