NO textures/bookshelf.xpm
SO textures/bookshelf.xpm
WE textures/bookshelf.xpm
EA textures/bookshelf.xpm

C 171,154,137
F 139,99,58

111111111111111 1111
111111000111111 1S11
111110000011111 1111
111100000001111
111000000000111
110000000000011
10000     00001
110000   000011
1110000 0000111
111100000001111
111110000011111
111111000111111
111111111111111
