NO textures/bookshelf.xpm
WE textures/bookshelf.xpm
SO textures/bookshelf.xpm



F 0,0,0
C 255,255,255

11111111
10000001
100N0001
11000001
11111111
